NO ./textures/wall.xpm
SO ./textures/wall.xpm
WE ./textures/wall.xpm
EA ./textures/wall.xpm

F 11,21,32
C 135,206,235

         111111111111
       1110000D00000111
     11100001111110000111
    110000011    110000011
   110000111      111000011
  11000011          11000011
  1000011            1100001
  100001              100001
  10W001              100001
  1000011            1100001
  11000011          11000011
   110000111      111000011
    110000011    110000011
     11100001111110000111
       1100000D00000011
        11111111111111







