F 11,21,32
NO ./textures/vine.xpm
SO ./textures/vine.xpm
C 135,206,235
                     WE ./textures/vine.xpm
EA ./textures/vine.xpm


1111                          1   1111
1001                              1ED1
1101                              1111                          111
 111                                                            101
1111111111111111111111111111111111111111111111111111111111111111111111
11111111 11111111111111111111
1
1                                                 111
1                                                1101
                                                  111


