NO ./textures/wall.xpm
SO ./textures/wall.xpm
WE ./textures/wall.xpm
EA ./textures/wall.xpm

F 11,21,32
C 135,206,235

111111
100001
100E01
100001
111111
