NO ./textures/vine.xpm
SO ./textures/vine.xpm
WE ./textures/vine.xpm
EA ./textures/vine.xpm
DO ./textures/door.xpm
F 11,21,32
C 135,206,235

 11111111111111111111111111111111111111
1000000000000000000000000000000000000001
10000000 0000000000000000000000000000001
1000000000000000000000000000000000000001
1000000000000000000000000000000000000001
1000000000000000001010000000000000000001
1000000000000000001010000000000000000001
1000000000000000001N10010000000000000001
1000000000000000001D10010000000000000001
1000000000000000000000000000000000000001
1000000000000000000000000000000000000001
1000000000000000000000000000000000000001
1000000000000000000000000000000000000001
1000000000000000000000000000000000000001
 11111111111111111111111111111111111111
