NO ./textures/birch.xpm
SO ./textures/cherry.xpm
WE ./textures/ice.xpm
EA ./textures/lava.xpm

F 205,180,219
C 189,224,254

        1111111111111111111111111
        1000000000110000000000001
        1011000001110000000000001
        1001000000000000000000001
111111111011000001110000000000001
10000000001100000111011111D111111
11110111111111011100000010N01
11110111111111011101010010001
11000000110101011100000010001
10000000000000001100000010001
10000000000000001101010010001
1100000111010101111101111000111
11110111 1110101 101111010001
11111111 1111111 111111111111
