NO ./textures/oak.xpm
SO ./textures/oak.xpm
WE ./textures/oak.xpm
EA ./textures/oak.xpm

F 160,82,45
C 135,206,235

        11E11111111
      11100000000111
     111000110100001
     100001100100001
   1110111100010001
  110000111111100001
  100000000000000011
  10000011111111101
  10000000000000001
  11111111111111111
